29 29 29 29 29 29 29 3 4 29 29 29 29 29 29 29 29 29 29 29 29 29 29 29 29 29 
29 29 29 29 29 29 0 13 4 29 29 29 29 29 29 29 29 29 29 29 29 29 29 29 29 0 
29 29 29 29 29 29 5 11 4 29 29 29 29 29 29 29 29 29 29 29 29 29 29 0 1 13 
29 29 29 29 29 29 29 5 12 2 29 29 29 29 29 29 29 29 29 29 29 0 1 13 10 6 
29 29 29 29 29 29 29 29 5 12 2 29 29 29 29 29 23 29 0 1 1 13 29 10 7 29 
29 29 29 29 29 29 29 29 29 3 12 1 1 1 1 1 1 1 13 29 10 6 6 7 29 29 
29 29 29 29 29 29 29 29 29 5 11 29 10 6 6 6 6 6 11 10 7 29 29 29 29 29 
1 1 1 1 1 2 29 29 29 29 3 10 7 29 29 0 2 29 5 4 29 29 29 29 29 29 
10 6 6 6 6 12 1 2 29 29 3 4 29 0 1 13 12 2 29 9 29 29 29 29 29 29 
7 29 29 29 29 5 6 12 1 1 13 4 29 5 11 29 29 12 2 9 29 29 29 29 29 29 
29 29 29 29 29 29 29 5 6 11 29 4 29 29 5 11 29 29 4 5 2 29 29 29 29 29 
29 29 29 29 29 29 29 29 29 5 11 12 2 29 29 5 11 29 4 29 9 29 29 29 29 29 
29 29 29 29 29 29 29 29 29 29 5 11 12 2 29 29 3 29 4 29 9 29 29 29 29 29 
29 29 29 29 29 29 29 29 29 29 29 5 11 12 2 29 5 6 7 29 9 29 29 29 29 29 
29 29 29 29 29 29 29 29 29 29 29 29 3 29 12 2 29 29 29 0 7 29 29 29 29 29 
29 29 29 29 29 29 29 29 29 29 29 29 3 29 29 12 1 2 29 9 29 29 29 29 29 29 
29 29 29 29 29 29 29 29 29 29 29 29 3 29 29 29 29 12 1 4 29 29 29 29 29 29 
29 29 29 29 29 29 29 29 29 29 29 0 13 10 6 6 11 29 29 12 1 1 2 29 29 29 
29 29 29 29 29 29 29 29 29 29 0 13 29 4 29 29 5 6 11 29 29 29 12 1 1 1 