22 22 22 22 22 22 22 19 18 22 22 22 22 22 22 23 22 22 22 23 22 22 22 23 22 22 
22 23 22 22 23 22 18 18 21 22 23 22 22 23 22 22 22 22 22 22 22 22 22 22 22 18 
22 22 22 22 22 22 21 18 18 22 22 22 22 22 22 23 22 23 22 22 23 22 22 18 18 19 
22 22 22 23 22 23 22 18 19 18 22 22 22 23 22 22 22 22 22 22 22 21 18 20 18 18 
22 23 22 22 22 22 22 22 18 18 19 23 22 22 22 22 22 22 18 19 18 18 19 18 18 22 
22 22 22 22 22 22 22 23 22 18 18 18 18 19 18 18 21 18 18 18 20 18 18 18 22 22 
22 23 22 22 23 22 22 22 22 19 18 21 18 18 19 18 18 18 19 18 18 22 22 23 22 23 
18 20 18 18 20 18 22 22 22 23 18 18 19 23 22 28 28 22 18 21 22 22 22 22 22 22 
18 18 21 18 18 18 18 20 22 22 21 18 23 28 28 28 28 28 22 18 22 22 22 22 22 22 
21 22 22 22 22 20 18 18 19 18 18 18 22 28 28 28 28 28 28 21 23 22 22 23 22 22 
22 22 22 23 22 22 22 21 18 18 21 18 23 22 28 28 28 28 28 18 20 22 22 22 22 22 
22 23 22 22 23 22 23 22 22 18 18 18 19 22 23 28 28 28 28 22 18 22 22 22 22 23 
22 22 22 22 22 22 22 22 23 22 18 20 18 18 22 22 28 28 28 22 18 23 22 23 22 22 
22 22 22 23 22 22 22 22 22 22 22 18 18 21 18 22 28 28 28 22 19 22 22 22 22 22 
22 22 22 22 22 22 23 22 22 22 23 22 18 18 18 20 22 22 22 21 18 22 22 22 23 22 
22 23 22 22 22 22 22 22 22 22 22 22 18 19 18 18 18 18 22 18 22 23 22 22 22 22 
22 22 22 23 22 22 22 22 23 22 22 22 18 18 20 18 19 18 20 18 22 22 22 22 22 22 
22 23 22 22 23 22 22 22 22 22 22 20 18 21 18 18 18 18 18 18 18 18 19 22 23 22 
22 22 22 22 22 22 22 23 22 22 18 19 18 18 22 23 18 18 19 18 21 18 18 18 21 18 