5 5 5 5 5 5 5 5 5 5 5 5 5 5 5 5 5 5 5 5 5 5 5 5 5 5 5 5 5 5 5 5 5 5 5 5 5 5 
5 5 5 5 5 5 5 5 5 5 1 1 1 1 1 1 1 1 1 1 1 1 1 1 1 5 5 5 5 5 5 5 5 5 5 5 5 5 
5 5 5 5 5 5 5 1 1 1 1 4 4 4 4 4 4 1 1 2 2 2 2 2 1 3 3 3 3 3 5 5 5 5 5 5 5 5 
5 5 5 5 5 5 1 4 4 4 4 4 6 6 6 6 4 1 2 2 2 2 2 2 2 1 1 1 3 3 3 3 3 5 5 5 5 5 
5 5 5 5 5 5 1 4 6 6 6 6 6 6 6 6 4 1 2 2 2 2 2 2 2 1 1 1 1 1 3 3 3 3 5 5 5 5 
5 5 5 5 5 1 1 4 6 6 6 6 6 6 6 6 4 1 2 2 2 2 2 2 2 1 0 0 0 0 0 3 3 3 5 5 5 5 
5 5 5 5 5 1 1 4 6 6 4 6 6 6 6 6 4 1 2 2 2 2 2 2 2 0 0 0 0 0 0 0 3 3 3 5 5 5 
5 5 5 5 1 1 1 4 6 6 4 6 6 6 6 6 4 1 2 2 2 2 2 2 1 0 0 0 0 1 1 1 1 3 3 5 5 5 
5 5 5 5 1 1 1 4 4 4 4 6 6 6 6 6 4 1 2 2 2 2 2 1 0 0 0 0 1 2 2 2 1 1 3 3 5 5 
5 5 5 1 1 1 1 1 1 1 4 6 6 6 6 6 4 1 2 2 2 2 1 1 0 0 0 1 1 2 2 2 1 1 3 3 5 5 
5 5 5 1 1 2 2 2 2 1 4 6 6 4 4 4 4 1 2 2 2 2 1 1 0 0 1 1 1 2 2 2 2 1 1 3 5 5 
5 5 5 1 2 2 2 2 2 1 1 0 0 1 1 1 1 2 2 2 2 1 1 0 0 0 1 1 1 1 2 2 2 1 1 3 5 5 
5 5 5 1 2 2 2 2 2 1 1 0 0 1 1 7 1 2 2 2 1 1 0 0 0 1 1 1 1 1 1 1 1 1 1 5 5 5 
5 5 5 1 2 2 2 2 2 2 1 0 0 0 1 1 1 1 1 1 1 0 0 0 0 1 1 1 4 4 4 4 4 4 1 5 5 5 
5 5 5 1 2 2 2 2 2 2 1 1 0 0 0 1 1 1 1 0 0 0 0 0 1 1 1 1 4 4 4 4 4 4 4 5 5 5 
5 5 5 1 1 2 2 2 2 2 1 1 1 0 0 0 0 0 0 0 0 0 0 1 1 1 1 4 5 5 5 5 5 5 4 5 5 5 
5 5 5 1 1 2 2 2 2 2 1 1 1 0 0 0 0 0 0 0 0 0 1 1 1 1 1 4 5 5 5 5 5 5 5 5 5 5 
5 5 5 4 1 1 2 2 2 2 1 1 0 0 0 1 0 0 0 0 1 1 1 1 1 1 4 5 5 5 5 5 5 5 5 5 5 5 
5 5 5 4 1 1 1 1 1 1 1 0 0 0 0 1 1 1 1 1 1 1 1 1 4 4 4 5 5 5 5 5 5 5 5 5 5 5 
5 5 5 5 4 4 4 1 1 1 0 0 0 0 1 1 1 1 1 1 1 1 4 4 4 4 5 5 5 5 5 5 5 5 5 5 5 5 
5 5 5 5 4 4 4 4 4 4 4 4 0 0 1 1 1 4 4 4 4 4 4 4 5 5 5 5 5 5 5 5 5 5 5 5 5 5 
5 5 5 5 5 5 5 4 4 4 4 4 4 4 4 4 4 4 4 4 4 4 5 5 5 5 5 5 5 5 5 5 5 5 5 5 5 5 
5 5 5 5 5 5 5 5 5 5 5 5 4 4 4 4 4 5 5 5 5 5 5 5 5 5 5 5 5 5 5 5 5 5 5 5 5 5 
5 5 5 5 5 5 5 5 5 5 5 5 5 5 5 5 5 5 5 5 5 5 5 5 5 5 5 5 5 5 5 5 5 5 5 5 5 5 
5 5 5 5 5 5 5 5 5 5 5 5 5 5 5 5 5 5 5 5 5 5 5 5 5 5 5 5 5 5 5 5 5 5 5 5 5 5 
5 5 5 5 5 5 5 5 5 5 5 5 5 5 5 5 5 5 5 5 5 5 5 5 5 5 5 5 5 5 5 5 5 5 5 5 5 5 