5 5 5 5 5 5 5 5 5 5 5 5 5 5 5 5 5 5 5 5 5 5 5 5 5 5 5 5 5 5 5 5 5 5 5 5 5 5 5 5 
5 4 4 4 4 4 4 4 5 5 5 5 5 5 5 5 5 3 3 0 0 3 3 3 5 5 5 5 5 5 5 5 5 5 5 5 5 5 5 5 
5 4 6 6 6 6 6 4 5 5 5 5 5 5 5 5 5 3 3 0 0 3 3 3 3 3 5 5 5 5 5 5 5 5 5 5 5 5 5 5 
5 4 6 6 6 6 6 4 5 5 5 5 5 5 5 5 3 3 3 0 0 3 3 3 3 3 3 3 5 5 5 5 5 5 5 5 5 5 5 5 
5 4 6 6 6 4 4 4 3 5 5 5 5 5 5 3 3 3 0 0 0 1 3 3 3 3 3 3 3 3 5 5 5 5 5 5 5 5 5 5 
5 4 6 6 6 4 3 3 3 3 3 3 3 3 3 3 3 0 0 0 0 1 1 3 3 3 3 3 3 3 3 3 3 3 3 5 5 5 5 5 
5 4 4 6 4 4 3 3 3 3 3 3 3 3 3 3 0 0 0 1 1 1 1 1 3 3 3 3 3 3 3 3 3 3 3 3 3 3 3 5 
5 1 0 0 0 3 3 3 3 3 3 3 3 3 3 0 0 0 1 1 1 1 1 1 1 1 3 3 3 3 3 3 3 3 3 3 3 3 3 5 
5 1 0 0 0 3 3 3 3 3 3 3 3 3 3 0 0 0 1 1 1 1 1 1 1 1 1 1 1 1 3 3 3 3 3 3 3 3 3 5 
5 1 0 0 0 0 3 3 3 3 3 3 0 0 0 0 0 0 1 1 1 1 1 1 1 1 1 1 1 1 1 1 1 1 1 1 3 3 3 5 
5 1 0 0 0 0 0 0 0 0 0 0 0 0 0 0 0 0 0 1 1 1 1 1 1 1 1 1 1 1 1 1 1 1 0 0 0 0 0 5 
5 1 0 0 0 0 0 0 0 0 0 0 0 0 0 0 0 0 0 0 0 1 1 1 1 1 1 1 1 1 1 0 0 0 0 0 0 0 0 5 
5 0 0 0 0 0 1 1 1 1 1 1 1 0 0 1 1 0 0 0 0 0 1 1 1 1 1 1 0 0 0 0 0 0 0 0 1 1 1 5 
5 1 0 0 0 1 1 1 1 1 1 1 4 6 6 4 1 1 1 1 0 0 0 0 1 1 1 0 0 0 0 0 0 1 1 1 1 1 1 5 
5 1 0 0 0 0 1 1 1 1 1 1 4 6 6 4 1 1 1 1 1 1 0 0 0 0 0 0 0 0 1 1 1 1 1 2 2 2 2 5 
5 1 1 0 0 0 1 1 1 1 1 1 4 6 6 4 4 4 4 4 4 4 4 0 0 0 0 0 1 1 1 1 1 2 2 2 2 2 2 5 
5 1 1 0 0 0 1 1 4 4 4 4 4 6 6 6 6 4 6 6 6 6 4 0 0 0 0 1 1 1 1 2 2 2 2 2 2 2 2 5 
5 1 1 0 0 0 0 1 4 6 6 6 4 6 6 6 6 4 6 6 6 6 4 1 0 0 0 1 1 1 2 2 2 2 2 2 2 2 2 5 
5 1 1 1 0 0 0 1 4 6 6 6 4 6 6 6 6 4 6 6 6 6 4 1 0 0 0 1 1 1 2 2 2 2 2 2 2 2 2 5 
5 1 1 1 0 0 0 1 4 6 6 6 6 6 6 6 6 6 6 6 6 6 4 1 0 0 0 1 1 2 2 2 2 2 2 2 2 2 2 5 
5 1 1 1 0 0 0 0 4 6 6 6 4 6 6 6 6 4 4 4 4 4 4 1 0 0 0 1 1 2 2 2 2 2 2 2 2 2 2 5 
5 1 1 1 1 0 0 0 4 4 4 4 4 4 6 6 6 6 6 6 6 6 4 1 0 0 0 1 1 1 2 2 2 2 2 2 2 2 2 5 
5 1 1 1 1 0 0 0 1 1 1 1 1 4 6 6 6 4 6 6 6 6 4 1 1 0 0 0 1 1 1 1 2 2 2 2 2 2 2 5
5 1 1 1 1 0 0 0 0 1 1 1 1 4 6 6 6 4 6 6 6 6 4 1 1 0 0 0 0 0 1 1 1 2 2 2 2 2 2 5 
5 1 1 1 1 0 0 0 0 0 0 1 1 4 4 4 4 4 4 4 4 4 4 0 0 0 0 0 0 0 0 0 1 1 1 2 2 2 2 5 
5 1 1 1 1 1 0 0 0 0 0 0 0 0 0 1 1 1 1 1 0 0 0 0 0 0 1 1 0 0 0 0 0 0 1 1 1 2 2 5 
5 1 1 1 1 1 0 0 0 1 1 0 0 0 0 0 0 0 0 0 0 0 0 1 1 1 1 1 1 1 1 0 0 0 0 0 1 1 1 5 
5 5 5 5 5 5 5 5 5 5 5 5 5 5 5 5 5 5 5 5 5 5 5 5 5 5 5 5 5 5 5 5 5 5 5 5 5 5 5 5